0000000000
0111111100
0100000100
0102000100
0111111100
0000000000